╔═════════╗                         ╔═════════╗
║         ║                         ║         ║
║         ╚═════════════════════════╝         ║
║                                             ║
║         ╔═══╗ ╔═════╗ ╔═════╗ ╔═══╗         ║
║         ║   ║ ║     ║ ║     ║ ║   ║         ║
╚═══╗ ╔═══╝╔══╝ ╚══╗  ║ ║  ╔══╝ ╚══╗╚═══╗ ╔═══╝
    ║ ║    ║       ║  ║ ║  ║       ║    ║ ║    
    ║ ║    ║       ║  ║ ║  ║       ║    ║ ║    
    ║ ╚════╝       ╚══╝ ╚══╝       ╚════╝ ║    
    ║                                     ║    
    ║ ╔════╗       ╔══╗ ╔══╗       ╔════╗ ║    
    ║ ║    ║       ║  ║ ║  ║       ║    ║ ║    
    ║ ║    ║       ║  ║ ║  ║       ║    ║ ║    
    ║ ║    ╚══╗ ╔══╝  ║ ║  ╚══╗ ╔══╝    ║ ║    
    ║ ║       ║ ║   ╔═╩ ╩═╗   ║ ║   ╔═══╝ ║    
    ║ ║       ║ ║   ║     ║   ║ ║   ║     ║    
    ║ ╚═══════╝ ╚═══╣ ╔═╗ ╠═══╝ ╚═══╝     ║    
    ║                 ║X║                 ║    
    ║ ╔═══════╗ ╔═══╣ ╚ ╝ ╠═══╗ ╔═══╗     ║    
    ║ ║       ║ ║   ║     ║   ║ ║   ║     ║    
    ║ ║       ║ ║   ╚═╦ ╦═╝   ║ ║   ╚═══╗ ║    
    ║ ║    ╔══╝ ╚══╗  ║ ║  ╔══╝ ╚══╗    ║ ║    
    ║ ║    ║       ║  ║ ║  ║       ║    ║ ║    
    ║ ║    ║       ║  ║ ║  ║       ║    ║ ║    
    ║ ╚════╝       ╚══╝ ╚══╝       ╚════╝ ║    
    ║                                     ║    
    ║ ╔════╗       ╔══╗ ╔══╗       ╔════╗ ║    
    ║ ║    ║       ║  ║ ║  ║       ║    ║ ║    
    ║ ║    ║       ║  ║ ║  ║       ║    ║ ║    
╔═══╝ ╚═══╗╚══╗ ╔══╝  ║ ║  ╚══╗ ╔══╝╔═══╝ ╚═══╗
║         ║   ║ ║     ║ ║     ║ ║   ║         ║
║         ╚═══╝ ╚═════╝ ╚═════╝ ╚═══╝   ╔═╗   ║
║                                       ║Ð    ║
║         ╔═════════════════════════╗   ╚═╝   ║
║         ║                         ║         ║
╚═════════╝                         ╚═════════╝