╔═════════╗                         ╔═════════╗
║         ║                         ║         ║
║         ╠═════════════════════════╣         ║
║                                             ║
║         ╠═══╗ ╔═════╗ ╔═════╗ ╔═══╣         ║
║         ║   ║ ║     ║ ║     ║ ║   ║         ║
╚═══╦ ╦═══╝╔══╩ ╩══╗  ║ ║  ╔══╩ ╩══╗╚═══╦ ╦═══╝
    ║ ║    ║       ║  ║ ║  ║       ║    ║ ║    
    ║ ║    ║       ║  ║ ║  ║       ║    ║ ║    
    ║ ╚════╣       ╠══╝ ╚══╣       ╠════╝ ║    
    ║                                     ║    
    ║ ╔════╣       ╠══╗ ╔══╣       ╠════╗ ║    
    ║ ║    ║       ║  ║ ║  ║       ║    ║ ║    
    ║ ║    ║       ║  ║ ║  ║       ║    ║ ║    
    ║ ║    ╚══╦ ╦══╝  ║ ║  ╚══╦ ╦══╝    ║ ║    
    ║ ║       ║ ║   ╔═╩ ╩═╗   ║ ║   ╔═══╩ ╣    
    ║ ║       ║ ║   ║     ║   ║ ║   ║     ║    
    ║ ╚═══════╝ ╚═══╣ ╔═╗ ╠═══╝ ╚═══╣     ║    
    ║                 ║X║                 ║    
    ║ ╔═══════╗ ╔═══╣ ╚ ╝ ╠═══╗ ╔═══╣     ║    
    ║ ║       ║ ║   ║     ║   ║ ║   ║     ║    
    ║ ║       ║ ║   ╚═╦ ╦═╝   ║ ║   ╚═══╦ ╣    
    ║ ║    ╔══╩ ╩══╗  ║ ║  ╔══╩ ╩══╗    ║ ║    
    ║ ║    ║       ║  ║ ║  ║       ║    ║ ║    
    ║ ║    ║       ║  ║ ║  ║       ║    ║ ║    
    ║ ╚════╣       ╠══╝ ╚══╣       ╠════╝ ║    
    ║                                     ║    
    ║ ╔════╣       ╠══╗ ╔══╣       ╠════╗ ║    
    ║ ║    ║       ║  ║ ║  ║       ║    ║ ║    
    ║ ║    ║       ║  ║ ║  ║       ║    ║ ║    
╔═══╩ ╩═══╗╚══╦ ╦══╝  ║ ║  ╚══╦ ╦══╝╔═══╩ ╩═══╗
║         ║   ║ ║     ║ ║     ║ ║   ║         ║
║         ╠═══╝ ╚═════╝ ╚═════╝ ╚═══╝   ╔═╗   ║
║                                       ║Ð    ║
║         ╠═════════════════════════╗   ╚═╝   ║
║         ║                         ║         ║
╚═════════╝                         ╚═════════╝