╔═════════╦═════════╦═════════╦═════════╦═════════╦═════════╗
║...................║.........║.........║.........║.........║
║.........║.........║.........║.........║.........|.........║
║.........║.........║.............................║.........║
║.........║.........║.........║.........║.........║.........║
║.........║.........║.........║.........║.........║.........║
╠═════════╩════.════╬════.════╩════.════╬════.════╬═════════╣
║...................║...................║.........║.........║
║...................║...................║.........║.........║
║.X.................║...................║.................Ð.║
║...................║...................║.........║.........║
║...................║...................║.........║.........║
╠════-════╦════.════╬════.════╦════.════╬════.════╬═════════╣
║.........║.........║.........║.........║.........║.........║
║.........║.........║.........║.........║.........║.........║
║.........║.............................║...................║
║.........║.........║.........║.........║.........║.........║
║.........║.........║.........║.........║.........║.........║
╚═════════╩═════════╩═════════╩═════════╩═════════╩═════════╝